R 1080 768

NO ./bluestone.xpm
SO ./greystone.xpm
WE ./redbrick.xpm
EA ./wood.xpm

S ./barrel.xpm
F 220,100,0
C 225,30,0

11111111
10001001
10002011
11102001
10000001
1000N001
10000001
11111111
