R 1080 768

NO ./bluestone.xpm
SO ./greystone.xpm
WE ./redbrick.xpm
EA ./wood.xpm

S ./path_to_the_sprite_texture
F 220,100,255
C 225,30,0

11111111
10001001
10000011
11100001
10000001
1000S001
10000001
11111111
